00000000000000000000
11111111111111111111
11111111111400000001
10111111111111100151
10111211511111100111
10000011000000000031
10110111110110101101
13100000000110101101
11101101110110000001
11100001110110111101
11101100000000111101
11100511111110111101
11111010000010111101
11100011111110111111
11000000000510000041
11111111111111111111