00000000000000000000
11111111111111111111
10000000000000000001
10111111111111111101
10111111111111100001
10110000000000101111
10110111000110101101
12100100010110101101
10101101110110000001
10101101110110111101
10101100000000111101
10100511111110111101
10111113333310130001
10100011111110111111
10001000000510000041
11111111111111111111