00000000000000000000
11111111111111111111
10000000121000000011
10000000101000000011
10000000101000000011
10000000101000000011
10000000101000000011
10000000101000000011
11111111101111111111
10000000000000000111
10100000011010000011
10110000111010010011
10110111130010000011
10110100111101000011
15110000041100010511
11111111111111111111