00000000000000000000
11111111111111111111
14000001000000000001
10111101011110111111
10000100011000000001
11110111111111111101
10000000011000000001
11111011111011111111
10000000011000000001
11111111011110111111
10001000011000000001
10101010111101111111
15100010011000000001
11111111011111111011
15000000000000000021
11111111111111111111