00000000000000000000
11111111111111111111
15111000000000111121
10001000111000111101
11100001111110111001
11111101111110110011
11100040011100100151
11100010011001001551
10000010000010015551
11000010000100155551
15100010001001555551
10010010010011111111
11001000100000000051
10100101001111111101
15010000000000000001
11111111111111111111